12 15
1 1 1 1 1 1 1 1 1 1 1 1 1 1 1
1 0 0 1 0 0 0 1 2 0 0 0 0 0 1
1 0 3 1 0 0 0 1 0 0 0 0 0 0 1
1 0 1 1 1 1 0 1 0 0 0 0 0 0 1
1 0 0 0 0 0 0 1 0 0 0 0 0 0 1
1 0 0 0 0 0 0 1 1 1 0 0 0 0 1
1 0 0 0 0 0 0 0 0 0 0 0 0 0 1
1 1 1 1 0 0 0 0 0 0 0 0 0 0 1
1 0 2 1 0 0 0 0 0 1 1 1 0 0 1
1 0 0 1 0 0 0 0 0 1 2 0 0 0 1
1 0 0 0 0 0 0 0 0 1 0 0 0 0 1
1 1 1 1 1 1 1 1 1 1 1 1 1 1 1
5 4 8 5
3 11 3 13